
5 1 9 1 8 1 1 10 1 1 0 
1 0 0 0 0 0 0 0 1 1 1 
5 0 0 0 0 0 0 0 1 0 1 
1 0 0 0 8 1 1 9 1 0 1 
1 1 1 1 1 0 0 0 1 1 1 
1 0 0 0 1 0 0 0 5 0 1 
7 0 0 0 5 0 0 1 1 0 1 
1 0 7 1 1 1 3 1 0 0 5 
5 0 1 0 0 0 0 0 0 5 1 
1 0 1 0 0 0 0 0 0 1 0 
8 1 6 1 1 1 1 7 1 1 0 

