
1 1 1 8 1 1 1 1 1 1 1 
1 0 1 0 0 6 0 0 0 0 1 
1 0 1 8 5 1 1 1 1 0 1 
1 1 1 0 0 0 0 0 8 1 1 
1 0 1 0 0 0 0 0 1 0 1 
8 1 1 1 1 8 1 1 8 1 1 
1 0 1 0 0 1 0 0 0 0 1 
1 0 1 1 1 1 1 1 1 0 1 
1 0 8 0 0 1 0 0 1 0 1 
1 0 1 0 0 1 0 0 1 0 1 
1 1 1 1 1 10 1 1 8 1 1 

