
1 1 1 8 1 1 1 9 1 1 1 
1 0 0 0 0 1 0 0 0 0 7 
1 0 7 1 1 1 1 1 8 0 1 
1 0 1 0 0 0 0 0 1 0 1 
6 1 1 0 0 0 0 0 7 1 10 
1 0 1 0 0 0 0 0 1 0 1 
1 0 3 0 0 0 0 0 9 0 1 
1 0 1 0 0 1 0 0 1 0 1 
2 0 1 1 5 1 1 2 1 0 1 
1 0 0 0 0 1 0 0 0 0 1 
4 1 1 1 1 1 4 1 1 1 5 

