1 1 9 1 1 8 0 0 0 0 0 
1 0 0 0 0 10 1 1 9 1 1 
1 0 0 0 0 1 0 0 0 0 1 
1 0 0 0 0 1 1 1 0 1 1 
9 1 1 0 0 0 0 9 1 0 9 
0 0 1 1 0 0 0 0 1 0 1 
0 0 1 9 1 6 0 0 1 0 8 
0 0 1 0 1 0 0 0 9 1 1 
0 0 1 3 1 9 1 7 1 0 0 
0 0 1 0 1 0 0 0 0 0 0 
0 0 1 1 1 0 0 0 0 0 0 

