
1 1 9 1 1 8 0 0 0 0 0 
1 0 0 0 0 10 1 1 5 1 1 
1 0 0 0 0 1 0 0 0 0 1 
1 0 0 0 0 1 1 1 0 1 1 
5 1 1 0 0 0 0 5 1 0 5 
0 0 1 1 0 0 0 0 1 0 1 
0 0 1 5 1 6 0 0 1 0 8 
0 0 1 0 1 0 0 0 5 1 1 
0 0 1 3 1 5 1 7 1 0 0 
0 0 1 0 1 0 0 0 0 0 0 
0 0 1 1 1 0 0 0 0 0 0 

