
0 8 1 1 1 9 1 1 0 0 0  
0 1 0 0 1 0 0 1 1 6 0  
0 1 0 0 1 0 0 0 0 1 0  
1 1 1 1 1 0 1 1 1 1 0  
8 0 0 1 0 0 8 0 0 0 0  
1 0 1 1 0 0 1 1 1 1 0  
1 0 9 0 0 0 0 0 0 1 0  
1 0 1 1 1 1 0 0 0 1 0  
1 1 1 0 0 1 0 0 0 1 0  
1 0 0 0 0 1 1 1 9 1 0  
10 1 1 1 1 1 0 0 0 0 0  

